

   

      NO       srcs/imgs/wall_text/a.xpm
SO		srcs/imgs/wall_text/b.xpm



EA srcs/imgs/wall_text/c.xpm



F 30,240,100

	    	WE   			 srcs/imgs/wall_text/d.xpm
C 40,100,240

        1111111111111111111111111
        1000000000110000000000001
        1011000001110000000000001
        1001000000000000000000001
111111111011000001110000000000001
100000000011000001110111111111111
1111011111111011100000010001
1111011111111011101010010001
11000000110101011100000010001
1000000000000001100000010001
100000W0000000001101010010001
110000011101010111110111100011
11110111 1110101 101111010001
11111111 1111111 111111111111
